1111111111111111111111111
1P100000000000000000000C1
1010000000000000000000011
1E0000C000000000000000001
1C10000000000000000000001
1111111111111111111111111